wwwwwwwwwwwwwwwwwww
w-----------------w
w-p---------------w
w-----------------w
w-----------------w
w-----------------w
w-----------------w
w-----------------w
w-----------------w
w----------------&w
wwwwwwwwwwwwwwwwwww
